1 1 1 1 1 1 1 1 1 1 1 1 1 1 1 1 1 1 1 1 1 1 1 1 1 1 1 1 1 1 1 1 1 1 1 1 1 1 
1 0 5 5 6 6 6 6 6 5 5 5 5 5 5 5 5 5 5 5 5 5 5 5 5 5 5 5 5 5 5 4 2 2 2 4 5 1
1 0 5 6 6 6 6 6 6 4 4 4 4 4 4 4 9 9 9 9 9 9 9 9 9 5 5 5 5 5 5 4 2 2 2 4 5 1
1 5 5 10 11 12 0 6 6 0 0 0 0 0 0 0 5 5 5 5 5 5 5 9 9 5 5 5 5 5 5 4 2 2 2 4 5 1
1 5 4 13 14 15 0 6 6 0 0 0 0 0 0 0 5 5 5 5 5 5 5 4 9 5 5 5 5 5 5 4 2 2 2 4 5 1
4 4 4 16 17 18 0 6 6 0 0 0 0 0 0 0 9 9 9 9 4 5 5 4 9 5 5 5 5 5 5 4 2 2 2 4 5 1
1 0 4 19 20 21 0 6 6 0 0 0 0 0 0 0 0 0 0 9 9 10 11 12 9 5 5 5 5 5 5 4 2 2 2 4 5 1
1 0 4 6 6 6 6 6 6 0 0 0 0 0 0 0 0 0 0 0 0 13 14 15 5 5 5 5 5 5 5 4 2 2 2 4 5 1
1 0 0 6 6 6 6 6 6 0 0 0 0 0 0 4 4 4 4 4 4 16 17 18 5 5 5 5 5 5 5 4 2 2 2 4 5 1
1 0 4 6 6 4 0 10 11 12 0 0 0 0 4 4 2 2 2 2 2 19 20 21 0 5 5 5 5 5 5 4 2 2 2 4 5 1
1 0 0 6 6 0 0 13 14 15 0 0 0 4 2 2 2 2 2 2 2 2 2 2 0 4 4 4 4 4 4 4 2 2 2 4 5 1
1 0 4 6 6 4 0 16 17 18 0 0 4 2 2 2 2 2 2 2 2 2 2 2 2 2 2 2 2 2 2 2 2 2 2 4 5 1
1 0 0 6 6 0 0 19 20 21 0 0 4 2 2 2 2 2 2 2 2 2 2 2 2 2 2 2 2 2 2 2 2 2 2 4 5 1
1 0 4 6 6 4 0 0 5 5 0 0 4 2 2 2 2 2 2 2 2 2 2 2 2 2 2 2 2 2 2 2 2 2 2 4 5 1 
1 0 0 6 6 0 0 0 5 5 0 0 0 4 4 4 2 2 2 2 2 2 0 0 4 4 4 4 4 4 4 4 4 4 4 4 4 4  
1 0 4 6 6 4 0 0 5 5 0 0 0 0 4 4 4 4 4 4 4 4 0 0 4 4 4 4 4 4 4 4 4 4 0 0 0 1
1 0 0 6 6 0 0 0 22 23 0 0 0 0 0 0 0 0 0 0 0 0 0 0 4 4 4 0 0 22 23 0 22 23 0 0 0 1
1 0 0 6 6 0 0 0 24 25 0 0 0 0 0 0 0 0 0 0 0 0 0 0 4 4 4 0 0 24 25 0 24 25 0 0 4 4 4
1 6 6 6 6 6 6 6 6 6 6 6 6 6 6 6 6 6 6 6 6 6 6 6 6 6 6 6 6 6 6 6 6 6 6 6 6 1
1 6 6 6 6 6 6 6 6 6 6 6 6 6 6 6 6 6 6 6 6 6 6 6 6 6 6 6 6 6 6 6 6 6 6 6 6 1
1 10 11 12 0 0 0 0 0 6 6 0 0 0 9 22 23 22 23 22 23 9 0 0 9 9 9 9 0 22 23 0 0 6 6 4 4 4
1 13 14 15 0 0 0 0 4 6 6 4 0 0 9 24 25 24 25 24 25 9 0 0 9 22 23 9 0 24 25 0 0 6 6 0 0 1
1 16 17 18 0 0 0 0 4 6 6 4 0 0 9 9 9 9 9 9 9 9 0 0 9 24 25 9 0 0 0 0 0 6 6 0 0 1
1 19 20 21 0 0 0 0 0 6 6 0 0 0 0 0 0 0 0 0 0 0 0 0 0 6 6 0 0 0 0 0 0 6 6 0 0 1
1 0 4 4 4 4 4 4 4 6 6 0 4 0 4 0 4 0 4 0 4 0 4 0 4 6 6 4 0 0 0 0 0 6 6 0 0 1
1 0 4 6 6 6 6 6 6 6 6 6 6 6 6 6 6 6 6 6 6 6 6 6 6 6 6 0 0 0 0 0 10 11 12 0 0 1
4 4 4 6 6 6 6 6 6 6 6 6 6 6 6 6 6 6 6 6 6 6 6 6 6 6 6 0 0 0 0 0 13 14 15 0 0 1
1 0 5 6 6 5 0 0 0 0 6 6 4 0 4 0 4 0 6 6 4 0 4 0 4 6 6 0 0 0 0 0 16 17 18 0 0 1
1 5 5 6 6 5 5 0 0 0 6 6 0 0 0 0 0 0 6 6 0 0 0 0 0 6 6 0 0 0 0 0 19 20 21 0 0 1
9 9 9 6 6 9 9 9 0 0 6 6 0 0 0 0 0 0 6 6 0 0 0 0 0 6 6 0 0 0 0 0 0 0 0 0 0 1
9 22 23 22 23 22 23 9 0 0 6 6 0 0 0 0 22 23 6 6 0 0 0 0 0 6 6 0 0 0 0 0 0 0 0 0 0 1
9 24 25 24 25 24 25 9 0 0 6 6 0 0 0 0 24 25 6 6 0 0 0 0 9 10 11 12 9 0 0 0 0 0 0 0 0 1
9 9 9 9 9 9 9 9 0 0 6 6 6 6 6 6 6 6 6 6 0 0 0 0 9 13 14 15 9 0 0 0 0 0 0 0 5 1
1 0 0 0 0 0 0 0 0 0 6 6 6 6 6 6 6 6 6 6 0 0 0 0 9 16 17 18 9 0 0 0 0 0 5 5 5 1
1 0 0 0 0 0 0 0 0 0 22 23 0 0 0 0 22 23 6 6 0 0 0 0 9 19 20 21 9 0 0 0 0 5 5 5 5 1
4 4 4 4 4 4 4 4 4 4 24 25 0 0 0 0 24 25 6 6 0 0 0 0 9 9 9 9 9 5 5 5 5 5 5 5 5 1
1 0 0 0 0 0 0 0 0 0 0 0 0 0 0 0 0 0 6 6 0 0 5 5 5 5 5 5 5 5 5 5 5 5 5 5 5 1 
1 0 0 0 0 0 0 0 0 0 0 0 0 0 0 0 0 0 6 6 0 5 5 5 5 5 5 5 5 5 5 5 5 5 5 5 5 1
1 1 1 1 1 1 1 1 1 1 1 1 1 1 1 1 1 1 1 1 1 1 1 1 1 1 1 1 1 1 1 1 1 1 1 1 1 1 
1 1 1 1 1 1 1 1 1 1 1 1 1 1 1 1 1 1 1 1 1 1 1 1 1 1 1 1 1 1 1 1 1 1 1 1 1 1 