1 1 1 1 1 1 1 1 1 1 1 1 1 1 1 1 1 1 1 1 1 1 1 1 1 1 1 1 1 1 1 1 1 1 1 1 1 1
1 4 4 4 4 4 4 0 0 4 31 2 2 2 2 2 32 0 0 0 31 2 2 2 2 2 2 32 0 0 0 0 0 0 0 0 0 1
1 4 4 4 4 4 4 0 4 0 31 2 2 2 2 2 32 0 0 0 31 2 2 2 2 32 0 0 0 0 0 0 0 0 0 0 0 1
1 4 10 11 12 4 4 4 4 0 31 2 2 2 2 32 0 31 2 2 2 2 2 2 32 0 0 0 0 0 0 0 0 0 0 0 0 1
1 4 13 14 15 0 0 0 0 0 0 31 2 2 2 2 2 2 2 2 2 2 2 32 0 0 0 10 11 12 33 34 35 36 0 0 0 1
1 4 16 17 18 0 0 0 0 0 0 0 31 2 2 2 2 2 2 2 2 2 2 32 0 0 0 13 14 15 37 38 39 40 0 0 0 1
1 4 19 20 21 4 4 4 4 4 0 0 0 31 2 2 2 2 2 2 2 2 2 32 0 0 0 16 17 18 41 42 43 44 0 0 0 1
1 4 29 29 29 29 29 29 29 29 29 29 29 29 29 29 29 28 28 28 28 28 29 29 29 29 0 19 20 21 45 40 47 48 0 0 7 1
1 4 29 29 29 29 29 29 29 29 29 29 29 29 29 29 29 28 28 28 28 28 29 29 29 29 29 29 29 29 0 4 4 4 4 0 0 1
1 4 29 29 29 0 0 0 0 0 0 0 0 0 0 0 31 2 2 2 2 2 2 32 0 29 29 29 29 29 0 4 4 4 4 0 0 1
1 4 0 0 0 0 33 34 35 36 0 0 0 0 0 31 2 2 2 2 2 2 2 2 32 0 0 0 29 29 0 4 4 4 4 0 0 1
1 4 33 34 35 36 37 38 39 40 0 0 31 2 2 2 2 2 2 2 2 2 32 0 0 0 0 0 29 29 0 0 0 0 0 0 0 1
1 4 37 38 39 40 41 42 43 44 0 0 31 2 2 2 2 2 2 2 2 2 2 32 0 0 0 0 29 29 0 0 0 0 0 0 0 1
1 4 41 42 43 44 45 40 47 48 0 0 31 2 2 2 2 2 2 2 2 2 2 32 0 0 0 0 29 29 0 0 0 1 1 1 1 1
1 4 45 40 47 48 4 4 4 4 0 0 0 0 31 2 2 2 2 2 2 2 2 2 2 32 0 0 29 29 29 29 29 29 29 29 29 29 29 29
1 4 4 4 4 4 4 4 4 0 0 0 0 0 0 31 2 2 2 2 2 2 2 2 32 0 0 0 29 29 29 29 29 29 29 29 29 29 29
1 0 0 0 0 0 0 0 0 0 0 0 0 0 0 4 31 2 2 2 2 2 2 32 0 0 0 0 29 29 0 0 0 0 1 1 1 1 1
1 0 0 0 0 0 0 0 0 0 0 0 0 0 4 4 4 9 9 27 27 27 9 4 4 0 0 9 22 23 9 0 0 0 0 0 0 0 1
1 0 0 10 11 12 9 22 23 0 0 0 0 0 4 4 4 4 9 27 27 27 9 4 4 0 0 9 24 25 9 0 0 0 0 0 0 1
1 0 0 13 14 15 9 24 25 0 0 4 4 4 4 4 4 4 9 27 27 27 9 4 4 0 0 9 22 23 9 0 0 4 4 4 4 1
1 0 0 16 17 18 0 0 0 0 0 9 9 9 9 9 9 9 9 27 27 27 9 9 4 0 0 9 24 25 9 0 0 4 4 4 4 1
1 0 0 19 20 21 0 0 0 0 0 31 2 2 2 2 2 2 2 2 2 2 2 2 2 32 0 0 29 29 0 0 0 4 4 4 4 1
1 0 0 0 0 0 0 0 0 0 0 0 0 31 2 2 2 2 2 2 2 2 2 2 2 2 32 29 29 29 29 0 0 0 0 0 0 1
1 0 0 0 0 0 0 0 0 0 0 0 0 0 0 31 2 2 2 2 2 2 2 2 2 2 32 29 29 29 29 0 0 0 0 0 0 1
1 9 9 9 9 0 0 33 34 35 36 0 0 0 0 31 2 2 2 2 2 2 2 2 2 2 32 0 29 29 0 0 10 11 12 0 0 1
1 2 2 2 9 0 0 37 38 39 40 0 0 0 31 2 2 2 2 2 2 2 2 2 2 32 0 0 0 0 0 0 13 14 15 0 0 1
1 2 2 2 9 0 0 41 42 43 44 0 0 0 31 2 2 2 2 2 2 2 2 2 2 32 0 0 0 0 0 0 16 17 18 0 0 1
1 2 2 2 9 0 0 45 40 47 48 0 0 0 31 2 2 2 2 2 2 2 2 2 2 32 0 0 0 0 0 0 19 20 21 0 0 1
1 2 2 2 9 0 0 9 9 9 9 0 0 0 31 2 2 2 2 2 2 2 2 2 2 32 0 0 0 0 0 0 0 0 0 0 0 1
1 9 9 9 9 0 0 0 0 0 0 0 0 0 31 2 2 2 2 32 0 0 0 0 0 0 0 33 34 35 36 0 0 0 0 0 0 1
1 9 9 9 0 0 0 0 0 0 0 0 0 31 2 2 2 2 32 4 0 0 0 0 0 0 0 37 38 39 40 33 34 35 36 0 0 1
1 0 0 9 9 9 9 9 9 0 0 0 0 31 2 2 2 32 4 4 4 4 4 4 4 0 0 37 38 39 40 37 38 39 40 0 0 1
1 0 0 9 22 23 22 23 9 2 27 27 2 2 2 2 32 4 4 10 11 12 10 11 12 0 0 41 42 43 44 37 38 39 40 0 0 0 1
1 0 0 9 24 25 24 25 9 2 27 27 2 2 2 2 32 4 4 13 14 15 13 14 15 0 0 45 40 47 48 41 42 43 44 0 0 1
1 0 0 9 9 0 0 9 9 0 0 0 31 2 2 2 32 4 4 16 17 18 16 17 18 0 0 0 33 34 35 36 40 47 48 0 0 1
1 0 0 9 9 0 0 9 9 0 0 0 0 9 9 9 9 4 4 19 20 21 19 20 21 0 0 0 37 38 39 40 0 0 0 0 0 1
1 0 0 0 0 0 0 0 0 0 0 0 0 0 0 0 0 0 0 0 0 0 0 0 0 0 0 0 41 42 43 44 0 0 0 0 0 1
1 0 0 0 0 0 0 0 0 0 0 0 0 0 0 0 0 0 0 0 0 0 0 0 0 0 0 0 45 40 47 48 0 0 0 0 0 1
1 1 1 1 1 1 1 1 1 1 1 1 1 1 1 1 1 1 1 1 1 1 1 1 1 1 1 1 1 1 1 1 1 1 1 1 1 1
